Débutant
+---+---+---+---+
| C |   | K |   |
+---+---+---+---+
|   | F |   |   |
+---+---+---+---+
| P |   |   |   |
+---+---+---+---+
|   |   |   |   |
+---+---+---+---+