Intermédiaire
+---+---+---+---+
|   |   |   | F |
+---+---+---+---+
|   |   |   | C |
+---+---+---+---+
| F | T |   |   |
+---+---+---+---+
|   |   | C |   |
+---+---+---+---+