Intermédiaire
+---+---+---+---+
|   |   |   |   |
+---+---+---+---+
|   | T |   | C |
+---+---+---+---+
|   | Q | C |   |
+---+---+---+---+
| T |   |   |   |
+---+---+---+---+