Intermédiaire
+---+---+---+---+
| T | C |   |   |
+---+---+---+---+
|   |   |   | T |
+---+---+---+---+
| F |   |   |   |
+---+---+---+---+
|   | F |   |   |
+---+---+---+---+