Avancé
+---+---+---+---+
|   | T |   |   |
+---+---+---+---+
| F |   | T | C |
+---+---+---+---+
|   | P |   |   |
+---+---+---+---+
|   | F |   |   |
+---+---+---+---+