Intermédiaire
+---+---+---+---+
|   |   |   | C |
+---+---+---+---+
|   | C |   |   |
+---+---+---+---+
| F |   |   |   |
+---+---+---+---+
| F | P |   |   |
+---+---+---+---+