Avancé
+---+---+---+---+
|   | F |   |   |
+---+---+---+---+
| C |   |   |   |
+---+---+---+---+
|   | F | C |   |
+---+---+---+---+
| P | P |   |   |
+---+---+---+---+