Intermédiaire
+---+---+---+---+
| P |   |   |   |
+---+---+---+---+
|   | Q |   |   |
+---+---+---+---+
|   |   | T | C |
+---+---+---+---+
| C |   |   |   |
+---+---+---+---+