Avancé
+---+---+---+---+
|   | T | Q |   |
+---+---+---+---+
|   |   |   | P |
+---+---+---+---+
| F | C |   |   |
+---+---+---+---+
| P |   |   |   |
+---+---+---+---+