Intermédiaire
+---+---+---+---+
|   | T |   |   |
+---+---+---+---+
|   | Q |   |   |
+---+---+---+---+
|   |   | C | F |
+---+---+---+---+
| T |   |   |   |
+---+---+---+---+