Avancé
+---+---+---+---+
|   |   |   | T |
+---+---+---+---+
|   | C |   | F |
+---+---+---+---+
| P |   | Q |   |
+---+---+---+---+
|   |   | T |   |
+---+---+---+---+