Avancé
+---+---+---+---+
|   |   |   | P |
+---+---+---+---+
| T |   |   |   |
+---+---+---+---+
|   | F |   | T |
+---+---+---+---+
| F |   | P |   |
+---+---+---+---+