Expert
+---+---+---+---+
|   | C |   | F |
+---+---+---+---+
|   |   |   |   |
+---+---+---+---+
| T | T |   |   |
+---+---+---+---+
| C |   | F |   |
+---+---+---+---+