Expert
+---+---+---+---+
|   | T | T |   |
+---+---+---+---+
|   | F |   | P |
+---+---+---+---+
| C | F |   |   |
+---+---+---+---+
| C |   |   |   |
+---+---+---+---+