Intermédiaire
+---+---+---+---+
| C |   |   |   |
+---+---+---+---+
| T |   | Q |   |
+---+---+---+---+
|   |   |   | C |
+---+---+---+---+
| F |   |   |   |
+---+---+---+---+