Débutant
+---+---+---+---+
|   |   |   |   |
+---+---+---+---+
|   |   | T |   |
+---+---+---+---+
| F | Q |   |   |
+---+---+---+---+
|   | K |   |   |
+---+---+---+---+