Expert
+---+---+---+---+
|   |   |   | C |
+---+---+---+---+
|   |   |   | T |
+---+---+---+---+
| F | F | C |   |
+---+---+---+---+
| T | P | P |   |
+---+---+---+---+