Intermédiaire
+---+---+---+---+
|   |   | C |   |
+---+---+---+---+
| F |   |   |   |
+---+---+---+---+
|   | Q |   | T |
+---+---+---+---+
| T |   |   |   |
+---+---+---+---+