Avancé
+---+---+---+---+
|   | C |   |   |
+---+---+---+---+
|   | P | F | F |
+---+---+---+---+
|   |   | Q |   |
+---+---+---+---+
| T |   |   |   |
+---+---+---+---+