Expert
+---+---+---+---+
|   |   |   | F |
+---+---+---+---+
|   |   |   | T |
+---+---+---+---+
| F | C | C |   |
+---+---+---+---+
| P | P | T |   |
+---+---+---+---+