Expert
+---+---+---+---+
|   | F | C |   |
+---+---+---+---+
|   | F | P |   |
+---+---+---+---+
|   | T |   |   |
+---+---+---+---+
| P | C |   |   |
+---+---+---+---+