Expert
+---+---+---+---+
|   | T |   | P |
+---+---+---+---+
| C | T |   |   |
+---+---+---+---+
|   | F |   |   |
+---+---+---+---+
|   | F | C |   |
+---+---+---+---+