Débutant
+---+---+---+---+
|   |   |   |   |
+---+---+---+---+
|   | T | P |   |
+---+---+---+---+
| P | T |   |   |
+---+---+---+---+
|   |   |   |   |
+---+---+---+---+