Débutant
+---+---+---+---+
|   | T |   |   |
+---+---+---+---+
|   | K |   |   |
+---+---+---+---+
| F | F |   |   |
+---+---+---+---+
|   |   | T |   |
+---+---+---+---+