Intermédiaire
+---+---+---+---+
|   |   | P |   |
+---+---+---+---+
|   |   |   |   |
+---+---+---+---+
| T | C |   | T |
+---+---+---+---+
|   | P |   |   |
+---+---+---+---+