Expert
+---+---+---+---+
|   |   |   | C |
+---+---+---+---+
|   |   | C |   |
+---+---+---+---+
|   | T | T | P |
+---+---+---+---+
| P | F |   |   |
+---+---+---+---+