Avancé
+---+---+---+---+
|   | P |   |   |
+---+---+---+---+
|   | Q |   |   |
+---+---+---+---+
| T |   |   |   |
+---+---+---+---+
| T |   | C | F |
+---+---+---+---+