Intermédiaire
+---+---+---+---+
|   |   | T |   |
+---+---+---+---+
| F | F |   |   |
+---+---+---+---+
| C |   |   |   |
+---+---+---+---+
|   |   | C |   |
+---+---+---+---+