Débutant
+---+---+---+---+
|   |   | Q |   |
+---+---+---+---+
|   |   | P |   |
+---+---+---+---+
| C |   |   |   |
+---+---+---+---+
|   | P |   |   |
+---+---+---+---+